##################################################
#................................................#
#................................................#
#................................................#
#................................##..............#
#................................................#
#................................................#
#........####....................................#
#................................................#
#................................................#
#................................................#
#................................######..........#
#................................................#
#................................................#
#................................................#
#.........##.....................................#
#................................................#
#............................###.................#
#................................................#
#................................................#
#.........###....................................#
#................................................#
#................................................#
#................................................#
#................................................#
#................................................#
#................................................#
#................###.............................#
#................................................#
#................................................#
#................................................#
#.................................###............#
#................................................#
#................................................#
#................................................#
#......................##........................#
#................................................#
#..........####..................................#
#................................................#
#................................................#
#................................................#
#................................................#
#................................................#
#................................................#
#................###.............................#
#................................................#
#................................####............#
#................................................#
#................................................#
##################################################