##################################################
#................................................#
#................................................#
#................................................#
#................................##..............#
#...............................................#
#..........................................EXXX..#
#........####..............................XXXX..#
#................................................#
#................................................#
#................................................#
#................................######..........#
#................................................#
#................................................#
#................................................#
#.........##.....................................#
#................................................#
#............................###.................#
#................................................#
#................................................#
#.........###....................................#
#................................................#
#................................................#
#................................................#
#................................................#
#................................................#
#................................................#
#................###.............................#
#................................................#
#................................................#
#................................................#
#.................................###............#
#................................................#
#................................................#
#................................................#
#......................##........................#
#................................................#
#..........####..................................#
#................................................#
#................................................#
#................................................#
#......XX........................................#
#................................................#
#................................................#
#...............X###.............................#
#................................................#
#................................####............#
#................................................#
#....XXXX........................................#
##################################################